14
1,7,5,5,7,5,5,5,6,3,5,5,5,6
3,12,3,5,13,7,7,6,10,11,7,7,5,14
11,5,13,5,7,12,10,10,9,13,12,11,5,14
9,7,5,5,13,5,12,9,5,5,5,13,6,10
3,15,7,7,5,5,7,5,5,7,7,5,12,10
10,10,10,10,2,3,13,5,6,8,8,3,6,10
8,10,8,11,13,12,3,6,9,5,5,14,9,14
2,11,4,9,5,6,9,14,1,5,5,15,7,12
10,11,4,3,5,13,5,13,7,5,7,12,9,6
10,9,7,13,4,1,7,5,13,7,13,6,3,12
10,3,12,2,2,1,15,5,4,11,5,13,13,6
11,13,6,10,10,1,15,5,4,11,5,6,1,14
11,5,12,10,9,5,13,5,5,13,5,14,3,12
9,5,5,13,5,5,5,5,5,5,5,13,13,4